10000000000
00023332000
00233333200
00232023200
00320002200
02332023300
02333333300
02333333300
02333233300
02332023300
23332233300
00000000004
